are you in the military	D
what kind of kids do you have in school	D
how many children in this household?	D
is sex an asset	D
what i have got?	D
what are otc drugs	o
are otc drugs	o
which antibiotics can be bought over the counter	o
what meds are over the counter?	o
what medications are otc	o
can pain meds be used as pain relievers	
what helps you for pain	
what pain relievers can be used in iv pain	
what pain relievers work	
does valium help with pain	
where can i find fintech	
where can I find finnables in the world	
where can i finnish a job	
where can i finn where can i finn	
where can i finnish a dbc	
what is d cough syrup	d
what is d cough syrup	d
what is d cough syrup fo	d
what d cough syrup	d
fod cough syrup	d
are the adults the kids	r
is the age for r adults the same as	r
are babies adult size	r
what is the age limit on r adults	r
is r adults	r
ai specific ai definition	r
what is a re	r
ai defined	r
how do ai's affect	r
re-specific ai re-reference definition	r
what to wear to allergy class d	s
what kind of sle for allergy	s
can you use a sleeve for allergy relief	s
can you wear a sleeve over a sleeve	s
what to wear with a sleeveless shirt	s
can you resuscitate a medication by injecting it into a muscle?	m
can you do a medication	m
can medication be used for nsaids?	m
what kind of medication can you take on a dr appointment	m
what is the difference between a medication and a controlled substance?	m
where do you find good meats for supper?	
where can i find good vegan food	
what should a good cook cook	
who should i recommend to my family	
where is your best tip for scuba diving	
do ny antacids have ny ingredients	n
what are the nyc antacids for	n
what ny antacids are for	n
what kind of antacids are good for kids in nyc	n
what ny meds are good for diarrhea	n
relief heartburn	h
is there any treatment for heartburn	h
will heartburn relieve	h
heartburn medicine	h
what is good for heartburn	h
can i carry your phone on my person	?
do you carry a wallet with you	?
how to carry your own wallet with you	?
do you carry a gun?	?
do you carry a gun in your pocket	?
is cimetidine drowsy	n
what is non-drowsy cozaar	n
what is non drowsy ointment	n
what is nys non-drowsy	n
can ativan cause drowsiness	n
is ld&flu medicare	l
what are flu medicare	l
what is ld and flu medicare	l
what medicare covers ld and flu	l
what are medicare flu benefits	l
where can ines be found	i
what is ines	i
what is the ines?	i
where can Ines be found	i
ines. what is its name	i
what is the earliest age for children to start doing math	I
what toys can i find children	I
where do children find friends?	I
when do I find children	I
where can i find children's literature	I
what is sri for fever	s
medication to lower fever	s
do fever reducers reduce a fever	s
medication that lowers fever	s
what meds reduce fever	s
where is eagles on the x box	?
where is the dvr on the sax player on the computer screen	?
what is the m?	?
what is the difference between a lcd and a lcd yahoo	?
where do i find an answer to this question	?
what is the a ldmc	m
what a meoileat	m
what is the a. a me towards the supporting.	m
who is the one i directed toward	m
which statement describes me towards a positive	m
where is vitami?	i
what is the isle of vitami	i
which island has vitami	i
isle of vitami	i
isle with vitami	i
are ns and supplemen the same	n
where are Ns, supplemen, or Supplemen found	n
supplemen define	n
what is supplemen	n
what is the difference between ns and supplemen	n
do you have ts or ts+	t
what is ts	t
do you have ts	t
what is a ts	t
do you have ts or ss	t
what nasal spray is used to treat allergic reaction	a
can nasal sprays be used for sinus problems	a
can nasal sprays be used with decongestant	a
what is nasal spray	a
what nasal spray	a
can a congested highway cause congestion	
i have congestion	
do you say congestion	
what is the most common cause of traffic congestion?	
what is the cause of congestion?	
what sects are there	
what sect is celibate	
are sects in pcw	
what is sect worship	
what is sectarian	
what is the ion for digestiv	i
what ion for digestiv	i
which of the following types of ion is used for digestiv?	i
digested ions	i
what is the best ion for digestivv	i
what is e-health product	e
what is e health	e
what is e health products	e
what product is e health product	e
what products are in the e health product cd?	e
what's a s?	s
can you s	s
what s means s-s?	s
what s do you do to a tummy tuck?	s
what s are s's?	s
can you mend your sleep	m
do mend any sleep apnea	m
what sleep do you need to mend	m
do you mend any sleep apnea	m
can mend a snore	m
where is my login to id	i
where to find my facebook id	i
where are my ids	i
where can i find my id number	i
where can i find my id	i
are band aids band aids	
do band aids come in a color	
where can i find band aids	
where do i find band aids	
where to find bandaid	
what first	a
what is the order to make in the list	a
what is the order for first	a
what's other first	a
what's the other?	a
can you use first aid kit as a substitute for first aid	a
do first aid stores buy supplies	a
what supplies are available for first aid	a
what is the basic purpose of first aid supplies?	a
what materialsborn in first aid	a
can you carry any aprylon medication	
can you carry extra lbs around	
do you carry any advil	
are you able to carry any items with you	
what should carry in purse	
what type of antihistamines are used for depression	n
what are ntihistamines?	n
is ntihistamine considered an antihistamine	n
what is the otc fo antihistamines	n
what are some antihistamine drugs	n
are seasonal allergies seasonal or aetna	r
when is allergen season	r
what is seasonal allergy	r
are allergens seasonal	r
what allergies can be caused by seasonal allergens	r
what are the gies for dummies	g
what type of gi are campaigns	g
is gie a term	g
is there a gies	g
what is a gies	g
specific shelf definition	
specific shelf	
what does'sssssssssssssssssss' mean	
what is specific for a specific shelf	
what is the different shelf	
what drops to use for eyes	f
do eye drops have to be used in your eye	f
what is the best thing to use for eye drops	f
what drops help eye drops work	f
what is the correct way to use eye drops	f
what is recommended for your web page	a
is an you recommend an an	a
what kind of tvs should i get?	a
what is the best analogue analogue converter	a
what is the best thematic books to buy	a
can the body use over-the-counter drugs?	
what is over the co	
which of these items has an over-the-cook designation	
what kind of products are over the counter	
is there any over the counter meds?	
what is an unter cream	u
is there cream for unter	u
what is the cream for unter	u
does elfrethylamine benzoyl peroxidase contain kdc	u
are there underarm creams	u
what is the cause of leg and shoulder pain?	
do you know what's wrong when your muscles are sore	
what makes the muscles hurt	
does pain from a muscle hurt	
causes of leg muscle pain	
what type of questions can you have for us	
what to do with extra money you received from your boss	
when you send money to someone do you think they should be able to tell them the difference between them and the person that sends them the money	
how to write a blog about children?	
do you have any questions about this topic	
pical ointment	p
pical ointment	p
pical ointment benefits	p
is pical ointment a pical ointment?	p
what is pical ointment used for	p
what you need to do for skin rash	f
what makes skin rash	f
what kind of cream for skin rash	f
what is the skin rash txt	f
do you have a skin rash?	f
where can i find finca information	
where to find the tanpana gpu	
where can i finn	
where can i find finnish	
where can i finnish my college education	
can oral rehydratioet be used for oral rehydratioet?	d
is rehydratiozable	d
what is an oral rehydratii	d
oral rehydratio oral rehydratio	d
is rehydrati oral a d or oral	d
what is the main solution to solving the problem?	o
why is software solutions often	o
is it possible to solve problems in your own house?	o
what is the solution to the word problem	o
what type of problems does the solutions based approach offer	o
where is there a section called what's the weather	
where is the section on syrians that deals with syrians?	
where is the section of the dictionary for medical terms	
where is the section for fmrt	
what tv channels are available in blc	
what is hysterics	
what sex is best for feminine hygienist	
what is hyste for	
what is the meaning of hy	
what is hygienic means	
what products are used to disinfection	g
what products are used for hygiene	g
which products are giene products	g
what is the giene product	g
what products are used for hygienist	g
can you recommend a good doctor to use	C
what kind of car can be bought at amazon	C
what is the best type of drools or ocd for men	C
can you recommend what is the best avn for your taste	C
can you recommenend a product	C
do probiotics contain probiotic	d
what do probiotics do for you?	d
probiotics list wiki	d
do probiotics come with probiotics	d
are probiotics probiotics	d
what are the benefits of gut health	
what to eat or drink to avoid gas and bloating	
what kind of food is good for the gut	
what supplements are good for digestion	
what is the healthiest dietary choice for a stomach	
what type of card does a woman carry	
do i need an id card in my pocket for my job	
do you carry around a handbag	
do you carry an address on your person	
what card do i carry	
which antifungal cre is the best?	y
what kind of cre should you take	y
what is antifungal cre	y
antifungal cre	y
antifungal cre	y
ams athlete definition	a
ams ams	a
ams ams for athlete	a
ams definition sports	a
ams stand for athlete	a
where is the foot scab	s
is there s foot	s
what is s foot?	s
how to remove s foot	s
what is the symptom of s foot	s
what is aisl definition	
what is the isl for aisl	
what is a specific isl	
aisl and its acronym	
what is an aisl	
e for diabetes	e
what is an e for diabetics	e
what is type e for diabetics	e
what is diabetic e for diabetics	e
diabetic e for s	e
where c is upply	u
where c is upplies	u
where c is upplies	u
where c is upplies	u
where c is the upplies location	u
what type of pregnancy is this	a
are you pregnancies	a
where do pregant woman find pregnancy	a
where to find pregnans	a
where can i find pregnancy	a
what is ncy test	n
what ncy test	n
can yny tests	n
can ncy tests	n
can y do can y	n
can we recommend any movie?	o
which product would you recommend to anyone	o
can we suggest any website to users	o
does anyone recommend any book?	o
what is your favourite kind of av equipment	o
is laxative a laxative	
are laxatives good for cimetidine	
what is the laxatives meds	
can laxatives cause constipation	
what type of laxative is prescribed for c. diff?	
onstipation reli	o
can relia onstipation	o
is relia or onstipation	o
causes of constipation reli reli	o
what is the cause of onstipation	o
what is ef	e
what is the ef	e
what is ef	e
do you have ef or ef	e
what is the ef	e
does amazon restock	a
what products can be used for sale at a garage sale	a
does icari use any product	a
are there any products for the human body	a
are there any products that are compatible with the ipod touch w/earfoam	a
ces smoke	
smoking cess	
smoking cess	
smoking ces?	
what smoking ces	
what is s?	o
what's on a slang text	o
what's the s in slang	o
what is ss on a tv	o
where is the symbol	o
ection for oral	e
oral ection	e
what is a ection for oral	e
what is an ection	e
what does ection for oral	e
what are care products	c
what product category is li	c
what is li - care	c
care product li	c
care products for li	c
what is toothpaste for	k
what is toothpaste an ke	k
what is toothpaste?	k
toothpaste, what kind of toothpaste	k
is toothpaste a food product?	k
what is d mouthwash used for	d
what is d mouthwash	d
can you use d mouthwash on your teeth	d
what is the chemical in d mouthwash?	d
what's the ingredient in d mouthwash?	d
which urls do you point to	
what to do if you see an error message in a file	
what type of url do you use to point to a link	
where do you find info on the doebbs	
wyoming state university in your name?	
aisle aisle meaning	w
what is the aisle of a wedding	w
aisle is to the wards	w
which aisle goes through the wedding	w
aisle of the aisle aisle	w
do i need a sunscreen	w
ohio what products have sunscreen	w
what kind of sunscreen can you use	w
what type of sunscreen do i use for a beach day	w
what sunscreen to use	w
prod nd skincare	n
what is nd skincare prod	n
does skincare prod have nd prods	n
what products are best for skincare	n
what is nd skincare prod	n
ucts definition	u
where can i get ucts	u
can you get uct credits	u
ucts where can they be found	u
ucts where can they be found	u
where can i find home	I
where to find home diag	I
how do i find homediag	I
where do i find home diag?	I
home diagnostics	I
nostic kits definition	n
nostic kits	n
nostic kits definition	n
nostic kit meaning	n
nostic kits	n
what is bp?	e
what is normal blood pressure e	e
what is the normal pressure for e	e
blood pressure level	e
what is e blood pressure	e
how many monitors in a pc	
how many screens can you use at once	
how many monitors in a room	
what r monitors	
what do you use as monitors	
can u carry any prod	u
prods does prod carry	u
can you carry prods	u
u carry any prods	u
what prods do u carry	u
what is uc predictive weight	u
what is the ucts weight scale	u
ucts for weight	u
what ucts to use for weight	u
what is uct	u
what is t management	m
t is t management	m
is t management	m
what is management? is t or m?	m
is t management?	m
which of the following describes the specific purpose of the specialized information in the special	h
where do you find specifics for a specifics	h
what is the difference between a specific location and a specific location	h
specifics what is this	h
what is the definition of specific here?	h
shelf for hair c	s
what is the hairstyling shelf	s
what is a shelf for hair	s
what is the shelf for hair on?	s
what is the hair shelf	s
what's the name of a product	a
what products?	a
are products a product	a
who are products? ca	a
what type of products do we sell	a
what products do you recommend	n
what is your recommendation	n
why i recommend you recommend?	n
can you recommend a nyc movie for my daughters r	n
what does the term Recommended	n
can any natural rememe natural	a
does natural rememeeve mean	a
do you do natural reme	a
what is natural reme	a
what is the reme of a natural plant	a
cold that you die of	d
what is cold death	d
what is it called when someone dies cold	d
which disease is fatal when a person drinks cold or hot drinks and dies	d
what kind of cold does die from	d
flu symptoms d flu symptoms	d
is flu an indicator of d flu	d
symptoms of the flu	d
symptoms of the flu	d
is the flu symptoms a symptom	d
how do i start my day in april	D
can i have a new ad based off this one	D
do you have a lot of babies	D
are you a person who likes to give and receive advice	D
what other sources are there for a medical doctor	D
str	p
what product e	p
products that are str	p
str	p
what str	p
definition of ess relief	e
ss relief definition	e
ess relief definition	e
what is a ense relief?	e
what is ess relief	e
what is a good place to get help for stress or anxiety?	x
xelo anxiety	x
anxiety & depression is due to what	x
what medication is good for anxiety?	x
where to get help for anxiety	x
where do i find condoms	
where to find condoms	
where to find condoms	
where do i find condoms	
where can i find condoms	
what type of contra	a
other contra	a
	a
list contra	a
contra	a
do ceptive contain contraceptives	c
which of the following ceptives is an operative contraceptive?	c
what is ceptive insertion?	c
is the suboxone a ceptive	c
cepts is the only medication that can be used to prevent pregnancy	c
what is an example of a section?	r
what is section re	r
what is section for	r
what is re re section	r
what is a section	r
are children's vitamins good	
what is children's vita	
what vitamin is best for children	
what vitamins do children take	
what vitamins are in children's vitae	
what is max mins and supplem	m
how long for mins and supplem to kick in	m
what is the difference between mins and supplems	m
what is mins and supplem used for	m
mins and supplem	m
what is ents	e
can you po po	e
what is the ent?	e
ents ets definition	e
can you po po po po	e
what kind of person is jini	i
what's tht's t	i
what is tha utme towards	i
what is teh meaning of the apush	i
which is a true statement about the int me	i
aisle with sm	h
aisle with sm	h
aisle with sm	h
aisle with smaw	h
what is the name of the aisle in the mall?	h
what do you cook oking accessory	o
what oking accessory is for grilling	o
what is an ok okk oking accessory	o
what is the oking accessory	o
what to do with a king size oking accessorie	o
what lighters are the same as lighter	s
what lighters are made of	s
what is lighters	s
what is lighter	s
what are lighters	s
do you carry a medkit	?
do you carry a bag around with you	?
do you carry a car pass or am I supposed to carry it	?
does anyone carry a backpack	?
do you carry a camera around in your pocket	?
what is the name of the pill used to oint antisept for nyc	n
what is the oral medication for nyc	n
what is the nyc antisept	n
what medications are considered antisept	n
what is nys antisept oral	n
what kind of ics for sore thr	i
is ics good for thr throat	i
what is ics for sore throat	i
what is ics for sore throat	i
what ics to take for sore throat	i
oat relief	o
can you use oats as a form of relief	o
what is oat relief	o
what is the relief of oats?	o
can oats help with a cough	o
a specific phrase definition	h
what is it the main purpose of a url	h
what specific problem is being addressed	h
specific name is	h
etiquette is a specific way to ________.	h
aisle for incont	a
what aisle is the incontinent aisle	a
aisle for incontinent aisle	a
aisle for incont	a
aisle number aisle inconpers	a
does inence have any products	i
what products inence	i
what is inence products	i
what is the inence	i
what is inence products	i
where can i find fin	
where can i fin an internship at	
where can i find fin Hoch	
what is the best place to find gold	
where can i find finnish	
what products does baby care have	d
prod baby care	d
what products are prod	d
d baby care baby care prod	d
what is the prods label for d baby care	d
ucts like diape	u
what is a uct?	u
diape what is the meaning of the word ucts	u
ucts are like	u
diapethymidine sulphuris, diapethymidine sulphuris	u
what is rs wipes	r
what's the difference between rs wipes and baby wipes?	r
rs baby wipes ingredients	r
what makes magazine rs and baby wipes	r
what is the difference between rs and baby wipes?	r
what is the s?	s
what is a tucson s?	s
what s	s
what is s?	s
how can i get s in my f***	s
does the product mend	m
does a product product mend?	m
what product should i have to mend	m
can you mend a product	m
what is the product code for the mend item	m
what is j.s for in	s
what is j&j stand for	s
what is the acronym s	s
what does s stand for in medical terms	s
what does s mean	s
is there arthritis pain	a
does arthritis cause pain	a
can arthritis cause pain?	a
can arthritis cause pain	a
does osteoarthritis cause pain	a
are any more lpns coming out	D
what kind of a job would you want if you were a baker	D
what is the best way to advertise your business	D
can you add to a list of things you are working on	D
zoosh do you have any ks4	D
what medicines are non-prescription	n
non prescription nolvadex	n
what is generic name for xanax	n
is aricept npt generic	n
what is non prescription ed	n
eye drops allergy	
what is eye dro used for	
what eye drooler for allergies	
what drool comes for allergy symptoms	
how is allergy eye dro	
what is a ps	p
what is ps	p
is there a ps	p
is there a ps	p
is ps a suffix	p
what is nutrient ection	e
what nutrient ection does nutrient nutrient release produce	e
what does nutrient mean	e
what is nutrient ection	e
what is nutrient	e
what is tional drinks	t
what type of drinks are tional drinks	t
what to eat in cdonalds	t
what are tional drinks	t
tional drinks	t
can you mix d shakes	d
can you eat shakes	d
are d shakes a good idea	d
can you eat d shakes	d
can you eat shakes	d
what is u point me towar	u
u point me towar?	u
where is wars	u
what is towar	u
where is towar kasim	u
the aisle is called what	d
wit os the aisle	d
what aisle is wit in	d
aisle wit definition	d
ds the aisle	d
wound care sup	h
wound care sup	h
wound care sup	h
what is wound care sup	h
wound care sup h wound care	h
where can plies be found	p
can plies be plies	p
where can plies be found in the world	p
where can a plies be found	p
where can plies be found	p
what is the car called in foot	
where do you find foot car	
where is the foot car	
what is the name of the foot pedal for car	
where can i find foot car seats	
what products to buy	e
what products are similar to e	e
what is like to purchase on amazon	e
is e-product a product	e
what types of products are used by electronic manufacturers	e
orthotics	
orthotics	
orthotics or co	
orthotics	
or	
what is rn pads	r
what are rn pads used for	r
rn pads should you use	r
what pad do rns use	r
what are the rn pads used for	r
carry any produc	c
does carry any product	c
carry any product	c
what type of product is	c
carry any product	c
what is ts urine	t
what is ts	t
what is ts	t
what is ts in health insurance	t
ts acronym urinary	t
what is ract health?	r
what is ract health	r
are ract health	r
is ract health	r
what is ract health	r
what is the most specific time someone is on vacation	t
is there a specific word in slang	t
is there a specific chemistry term for a specific type of medicine	t
is there a specific specific to be done after one ost	t
is there a specific location to which osrs is marketed	t
homeos shelf	
what kind of shelves are there in shelves	
what is the name of shelf for homeo	
what is a shelf for	
what is shelf in homeo	
what pathic remedies	p
pathic remedies	p
pathic remedies	p
pathic remedies for what	p
pathic remedies definition	p
do you know the name of the famous person that died of robinhood	
can you recommembr a website for an ipod	
what is the difference between a msn and a camino	
can you recommemd a best site for booking flight	
can you recommend a good website to visit	
are there vitamins in nsad	n
vitamins and minerals are good for health	n
what vitamins do you need for good health	n
can vitamins help with digestion	n
which vitamins do i need	n
what supplements fda approved	o
what is the name of the supplement that you are taking	o
what supplement is fda approved	o
what supplement should i take	o
what supplements or vitamins	o
what is hair and nails	o
hair nail nails	o
does hair nail growth	o
what is the difference between hair and nails	o
what is the name of nail color with hair on	o
do you have a health condition	
what is your health?	
what is your health?	
do you have physical health	
do you care about your health	
what products do	h
what products do you use	h
what products do u need	h
have a product	h
do you have any product	h
what s t for cold sore	s
what is good for cold sores	s
what is the best treatment for a cold sore	s
what medicine helps for cold sores	s
what s for cold sores	s
what is the difference between treatment and treatment and treatment	t
where is treatment given for malaria	t
where is treatment for treatment of cancer	t
where can you find the most effective treatment plan for you?	t
where are meds used for treatment	t
hear my answers	
where can i find hear hear the tv show	
where is a hear on this website	
what is hear	
where can i find hear hear	
aids and acc	i
what are some ing aids for rehab	i
ing aids and acc	i
what to think about hearing aids	i
what is medical and ing aids	i
can you use essories	e
can you add essories to a game	e
can you tinker in essories	e
can yo use essories in smr	e
can you put on the essories	e
what is towar	u
what is towar	u
where is towar	u
what is towar	u
towar tswar u point me towar	u
aisle wittin wittin aisles	d
aisle wit meaning	d
ds the aisle	d
aisle definition	d
the aisle wit the aisle	d
what is pet medication	h
what is the name of the medication for dog	h
what medication is h pet medication	h
medications that are good for dogs	h
h pet medication	h
what is s	s
what is the se in se	s
se s definition	s
what is s	s
is se a s	s
what is medica ction for	c
ction for medica	c
what is the medica	c
can a medica patient rely on medicare to be well taken care for	c
are medica and medicaid the same	c
what is the name of the device that you use to look up your phone	l
what is l device	l
what does l devices	l
what is the device l device	l
what kind of devices are there	l
what's a thermometer	t
what's a thermometer	t
which thermometer to use	t
what thermometer do you use for the air temperature in this room	t
what is thermometer used for?	t
	b
glucose blood sugar	b
glucose glucose	b
blood glucose glucose test glucose glucose glucose	b
glucose glucose mo	b
do you have nitors	n
what are the nitors	n
nitors definition	n
do you c nitors	n
what are nitors	n
are there any products arry	a
what products arry any product	a
what product line arry is arry in	a
what ar suffered because of the iri product	a
do you have to pay for arry	a
what s for infant col	s
infants definition	s
infant what is the infant	s
what does infant col mean	s
infant col	s
what is ic relief cream	i
can ya relieve ic?	i
can you use ic relief on a heat wound	i
what's ic relief	i
ic relief	i
what is the best brand for vaping	o
can you recommend any good books to read	o
can you recommend any good movies to watch	o
recommended sites to look at	o
how to recommend a movie	o
what is over the count	
what is over the counted	
what is the over-the-counted	
over the counting	
over the counted definition	
what is the nasal passages for allergies	r
nasal allergies symptoms	r
what type of allergies are found in the respiratory system	r
allergies in the nose	r
nasal allergens symptoms	r
what is sprays used for	s
does od spray have a shelf life	s
is spray on aerosol good	s
what is spray can	s
what kind of spray will you spray on your clothes	s
